|-----------------------------|
|            |-------------|  |
|            |.............|  |
|            |.............|  |
|            |.............|  |
|            |.............|  |
|            |.............|  |
|            |--+----------|  |
|               #             |
|         #######             |
|         #                   |
|         #  |-------------|  |
|         #  |.............|  |
|         #  |.............|  |
|         #  |.............|  |
|         #  |.............|  |
|         #  |.............|  |
|         #  |.............|  |
|         #  |.............|  |
|         #  |.............|  |
|         #  |.............|  |
|         ###+.............|  |
|            |.............|  |
|            |.............|  |
|            |.............|  |
|            |.............|  |
|            |.............|  |
|            |.............|  |
|            |.............|  |
|            |.............|  |
|            |.............|  |
|            |.............|  |
|            |-------------|  |
|-----------------------------|

