|-----------------------------------------------------------------------------|
|  |---------------------|          |-------------------------------|         |
|  |.....................|          |...............................|         |
|  |.....................|          |------+------------------------|         |
|  |.....................|     #############                                  |
|  |.....................|     #    |------+--------------------------------| |
|  |.....................|     #    |.......................................| |
|  |.....................+##########+.......................................| |
|  |.....................|          |.......................................| |
|  |---------------------|          |---------------------------------------| |
|-----------------------------------------------------------------------------|

