|----------------------------------------------------------------------------------------------------------------------------------------|
|                                                                                                                                        |
|    |---------------|     |---------------|     |---------------|     |---------------|     |---------------|     |---------------|     |
|    |...............|     |...............|     |...............|     |...............|     |...............|     |...............|     |
|    |...............|     |...............+#####+...............|     |...............|     |...............|     |...............|     |
|    |...............|     |...............|  #  |...............|     |...............|     |...............|     |...............|     |
|    |...............|     |...............|  #  |...............|     |...............|     |...............|     |...............|     |
|    |--------------+|     |--------------+|  #  |--------------+|     |+--------------|     |-------+-------|     |--------+------|     |
|                   #                     #   #                 #       #                            #                      #            |
|            ################################################################################################################            |
|            #                                                                  #                                                        |
|    |-------+-------|     |---------------|     |---------------|     |--------+------|     |---------------|     |---------------|     |
|    |...............|     |...............|     |...............|     |...............|     |...............|     |...............|     |
|    |...............|     |...............|     |...............|     |...............|     |...............|     |...............|     |
|    |...............|     |...............|     |...............|     |...............|     |...............|     |...............|     |
|    |...............|     |...............|     |...............|     |...............|     |...............|     |...............|     |
|    |--------------+|     |--------------#|     |--------------+|     |+--------------|     |-------+-------|     |--------+------|     |
|                   #                     #                     #       #                            #                      #            |
|                   #######################                     #############################################################            |
|                   #               #                           #                         #       #                     #                |
|    |--------------+|     |--------+------|     |--------------+|     |---------------|  #  |----+----------|     |----+----------|     |
|    |...............|     |...............|     |...............|     |...............+###  |...............|     |...............|     |
|    |...............|     |...............+#####+...............|     |...............|     |...............|     |...............|     |
|    |...............|     |...............|     |...............|     |...............|     |...............|     |...............|     |
|    |...............|     |...............|     |...............|     |...............|     |...............|     |...............|     |
|    |---------------|     |---------------|     |---------------|     |---------------|     |---------------|     |---------------|     |
|                                                                                                                                        |
|----------------------------------------------------------------------------------------------------------------------------------------|

