|------------------------------------------------------------------------------------------------------------|
|  |------------------------------------------------------------|                                            |
|  |............................................................|             |----------------------|       |
|  |............................................................|             |......................|       |
|  |............................................................+#############+......................|       |
|  |............................................................|             |----------+-----------|       |
|  |............................................................|                        #                   |
|  |............................................................|                      ###                   |
|  |------------------------------------------------------------|                   ###                      |
|                                                                                      ###                   |
|                                                                                         ###                |
|                                                                                           ###              |
|                                                                                              ###           |
|  |------------------------------------------------------------|                                 #          |
|  |............................................................|             |-------------------+--|       |
|  |............................................................|             |......................|       |
|  |............................................................|         ####+......................|       |
|  |............................................................|         #   |----------------------|       |
|  |............................................................|         #                                  |
|  |............................................................+##########                                  |
|  |------------------------------------------------------------|      #                                     |
|                                                                      #                                     |
|                                                                      #                                     |
|  |------------------------------------------------------------|      #                                     |
|  |............................................................|      #      |----------------------|       |
|  |............................................................|------+------|......................|       |
|  |.................................................................................................|       |
|  |............................................................|-------------|......................|       |
|  |............................................................|             |----------------------|       |
|  |------------------------------------------------------------|                                            |
|                                                                                                            |
|                                                                                                            |
|------------------------------------------------------------------------------------------------------------|

