|---------------------------------------------------------------------------------------------------|
|                                                                                                   |
| |---------------------------------------------------------------------------|                     |
| |...........................................................................|                     |
| |...........................................................................|                     |
| |---------------------------------------------+-----------------------------|                     |
|                                               #                                                   |
|                                               #                                                   |
|                                               #                                                   |
|                                      ###################                                          |
|                                      #                 #                                          |
|                                      #                 #                                          |
|           |--------------------------+---------|       #         |--------------------------|     |
|           |....................................|       #         |..........................|     |
|           |....................................+#################+..........................|     |
|           |....................................|                 |..........................|     |
|           |....................................|                 |..........................|     |
|           |....................................|                 |..........................|     |
|           |....................................|                 |..........................|     |
|           |....................................|                 |..........................|     |
|           |....................................|                 |..........................|     |
|           |....................................|                 |..........................|     |
|           |------------------------------------|                 |--------------------------|     |
|                                                                                                   |
|---------------------------------------------------------------------------------------------------|

