|-----------------------------------------------------------------------------|
|                                                                             |
| |--------------------------|        |-----------------------|               |
| |..........................|        |.......................|               |
| |..........................+########+.......................|-------|       |
| |..........................|   #    |...............................|--|    |
| |..........................|   #    |..................................|--| |
| |----------+---------------|   #    |---------------------|...............| |
|            #                 ###                          |...............| |
|            #                 #      |------------|        |...............| |
|            #                 #      |............|        |...............| |
|            ###################      |............|        |...............| |
|            #                        |............|        |...............| |
|            #                        |-----+------|        |--------------+| |
|            #                              #                              #  |
| |----------+---------------|        |-----+-----------------|            #  |
| |..........................|        |.......................|            #  |
| |..........................+########+.......................|-------|    #  |
| |..........................|   #    |...............................|--| #  |
| |..........................|   #    |..................................|-+| |
| |--------------------------|   #    |----+-----------------|..............| |
|    |----------|                ############                |..............| |
|    |..........|      ###########    |-----+------|         |..............| |
|    |..........|    ###              |............|         |..............| |
|    |..........+#####                |............|         |..............| |
|    |----------|                     |............|         |..............| |
|                                     |------------|         |--------------| |
|                                                                             |
|-----------------------------------------------------------------------------|

