|-----------------------------|                           |-----------------------------|
|            |-------------|  |                           |            |-------------|  |
|            |.............|  |                           |            |.............|  |
|            |.............|  |                           |            |.............|  |
|            |.............|  |                           |            |.............|  |
|            |.............|  |                           |            |.............|  |
|            |.............|  |                           |            |.............|  |
|            |--+----------|  |                           |            |--+----------|  |
|               #             |                           |               #             |
|         #######             |                           |         #######             |
|         #                   |                           |         #                   |
|         #  |-------------|  |---------------------------|         #  |-------------|  |
|         #  |.............|                                        #  |.............|  |
|         #  |.............|        |--------------|                #  |.............|  |
|         #  |.............|        |..............|                #  |.............|  | 
|         #  |.............|        |..............|                #  |.............|  |
|         #  |.............+########+..............+#################  |.............|  |
|         #  |.............|        |..............|                #  |.............|  |
|         #  |.............|        |--------------|                #  |.............|  |
|         #  |.............|                                        #  |.............|  |
|         #  |.............|  |---------------------------|         #  |.............|  |
|         ###+.............|  |                           |         ###+.............|  |
|            |.............|  |                           |            |.............|  |
|            |.............|  |                           |            |.............|  |
|            |.............|  |                           |            |.............|  |
|            |.............|  |                           |            |.............|  |
|            |.............|  |                           |            |.............|  |
|            |.............|  |                           |            |.............|  |
|            |.............|  |                           |            |.............|  |
|            |.............|  |                           |            |.............|  |
|            |.............|  |                           |            |.............|  |
|            |.............|  |                           |            |.............|  |
|            |-------------|  |                           |            |.............|  |
|-----------------------------|                           |-----------------------------|

