|------------------------------------------------------------------------------|
|                                                                              |
| |------|        |-----------------------|                                    |
| |......|        |.......................|                                    |
| |......+########+.......................|                                    |
| |......|   #    |.......................|                                    |
| |......|        |-----------------------|                            |------||
| |......|                                                             |......||
| |......|                                                             |......||
| |......|#######################             #########################+......||
| |......|                      ###############                        |......||
| |......|                                                             |------||
| |------|                                                                     |
|                                                                              |
|------------------------------------------------------------------------------|

