        |--------------------------------------------------------------------------------------------|
        |                                                                                            |
        |            |-----------------------------------------------------|                         |
        |            |.....................................................|                         |
        |            |.....................................................|   |--------------|      |
        |            |.....................................................|   |..............|      |
        |            |.....................................................+###+..............|      |
        |            |.....................................................|   |..............|      |
        |            |-----------------------------------------------------|   |..............|      |
|-------|                                                                      |..............|      |--------|
|                                                                              |.....|--------|               |
|                                                                              |.....|                        |
|  |------------------------------------------------------------|              |.....|                        |
|  |............................................................|              |.....|----------------|       |
|  |............................................................|              |......................|       |
|  |............................................................|              |......................|       |
|  |............................................................+##############+......................|       |
|  |............................................................|              |......................|       |
|  |............................................................|              |......................|       |
|  |............................................................|              |......................|       |
|  |............................................................|              |----------------------|       |
|  |............................................................|                                             |
|  |............................................................|                                             |
|  |------------------------------------------------------------|                                             |
|                                                                                                             |
|-------------------------------------------------------------------------------------------------------------|

